WWWWWWWWWWWWWWWWWWWWWWWWWWWWWWW
W     W     W       W         W
W   WWW     WW   E  W   WWWWWWW
W   W    W   WW WWWWW         W
W   W    W   WW               W
W   W   WW   WW  WWWWWW WWWW  W
W  WW   WW   W        W W     W
W       W             W W  WWWW
W       W             W W  WWWW
W       W             W W      
WWWWWWWWWWWWWWWWWWWWWWWWWWWWWWW