GWWWWWWWWWWWWWWWWWWWWWWWWWW
M           W     W       W
M   WWWWW   W     W   W   W
M   W   W   WWWW WW   W   W
M   W   W             W   W
M   W   WWWWWWWW WWWWWW  WW
M   WWWWW        W   WW   W
M       W        W    WW  W
M       W    W        W   W
M       W    W     W  W   W
M            W     W      W
LWWWWWWWWWWWWWWWWWWWWWWWWWW