GWWWWWTWWWWWTWWWWWTWWWWWWWD
M     M     M     M       M
M           M     M   M   M
M    GWWD   LWWW WR   M   M
M    MVPM      p      M   M
FWW  MBJFWWWWWWW TWWWWZ  WZ
M    LWWZ        M   WM   M
M       M        M    FW  M
M       M    M        M   M
M       M    M     M  M   M
M            M     M      M
LWWWWWWWWWWWWtWWWWWtWWWWWWR