GWWWWWWWWWWWWWWWWWWWWWWWWWD
M           M     M       M
M           M     M   M   M
M    GWWD   LWWW WR   M   M
M    MVPM             M   M
M    MBJFWWWWWWW TWWWWZ  WZ
M    LWWZ        M   WM   M
M       M        M    FW  M
M       M    M        M   M
M       M    M     M  M   M
M            M     M      M
LWWWWWWWWWWWWtWWWWWtWWWWWWR